1111111111
1000P00CC1
10011100C1
1001C10001
10000CC001
1100000011
1110001111
1111E11111
1111111111
1111111111
