11111
10CC1
1P101
100E1
11111
