111111111111111111
100P0000CC000C0001
1CC000000000E00001
111111111111111111
