111111111111
100C0P00E001
111111111111